00	00	00	00	00	00	00	00	00	00	00	00	00	00	00	00	00	00	00	00	00	00	00	00	00	00	00	00	00	00	00	00	00	00	00	00	00	00	00	00	00	00	00	00	00	00	00	00	00	00
00	03	03	03	03	03	03	03	03	03	03	03	03	03	03	03	03	03	03	03	03	03	03	06	01	01	06	01	04	05	01	01	01	01	01	01	01	01	01	01	01	01	01	01	01	01	01	01	01	00
00	01	01	01	01	01	01	01	01	01	01	01	01	01	01	01	01	01	01	01	01	01	01	01	01	01	01	01	04	05	01	01	01	01	01	01	01	01	01	01	01	01	01	01	01	01	01	01	01	00
00	01	01	01	01	01	01	01	01	01	01	01	01	01	01	01	01	01	01	01	01	04	05	01	01	01	01	01	01	01	01	01	01	01	01	04	05	01	01	01	01	01	01	01	01	01	01	01	01	00
00	02	02	02	02	02	02	02	02	02	02	02	01	01	02	02	01	01	01	01	01	04	05	01	01	01	01	01	01	01	01	01	01	01	01	04	05	01	01	01	01	01	01	01	01	01	01	02	02	00
00	01	01	01	01	01	01	01	01	01	01	01	01	01	03	03	01	01	01	01	01	01	01	01	01	01	01	01	01	01	04	05	01	01	01	01	01	01	01	01	01	01	01	04	05	01	01	03	03	00
00	01	01	01	01	01	01	01	01	01	01	01	01	01	01	01	01	01	01	01	01	01	01	01	01	01	01	01	01	01	04	05	01	01	01	01	01	01	04	05	01	01	01	04	05	01	01	01	01	00
00	01	01	01	01	01	01	01	01	01	01	01	01	04	05	01	01	02	02	01	01	01	02	02	01	01	01	02	02	01	01	01	01	01	01	01	01	01	04	05	01	01	01	01	01	01	01	01	01	00
00	01	01	01	01	01	01	01	01	01	01	01	01	04	05	01	01	03	03	01	01	01	03	03	01	01	01	03	03	01	01	01	01	01	01	01	01	01	01	01	01	01	01	01	01	01	01	01	01	00
00	02	02	02	02	02	02	02	02	02	02	02	01	01	01	01	01	01	01	01	01	01	01	01	01	01	01	01	01	01	01	01	01	01	02	02	01	01	01	01	01	01	01	01	01	01	01	02	02	00
00	03	03	03	03	03	03	03	03	03	03	03	01	01	01	01	01	01	01	01	01	01	01	01	01	01	01	01	01	04	05	01	01	01	03	03	01	01	01	01	01	01	01	01	01	01	01	03	03	00
00	01	01	01	01	01	01	01	01	01	01	01	01	01	01	01	01	01	01	01	01	04	05	01	01	01	01	01	01	04	05	01	01	01	01	01	01	01	01	01	01	01	01	01	01	01	01	01	01	00
00	01	01	01	01	01	01	01	01	01	01	01	01	02	02	01	01	01	01	01	01	04	05	01	01	01	01	01	01	01	01	01	04	05	01	01	01	01	04	05	01	01	02	02	01	01	01	01	01	00
00	01	01	01	01	01	01	01	01	01	01	01	01	03	03	01	01	01	01	01	01	01	01	01	01	01	01	01	01	01	01	01	04	05	01	01	01	01	04	05	01	01	03	03	01	01	01	01	01	00
00	02	02	02	02	02	02	02	02	02	02	02	01	01	01	01	01	02	02	01	01	01	01	01	01	01	01	01	04	05	01	01	01	01	01	01	01	01	01	01	01	01	01	01	01	01	01	02	02	00
00	03	03	03	03	03	03	03	03	03	03	03	01	01	01	01	01	03	03	01	01	01	01	01	01	01	01	01	04	05	01	01	01	01	01	02	02	01	01	01	01	01	01	01	01	01	01	03	03	00
00	01	01	01	01	01	01	01	01	01	01	01	01	01	01	01	01	01	01	01	01	01	04	05	01	01	01	01	01	01	01	01	01	01	01	03	03	01	01	01	01	01	01	01	01	01	01	01	01	00
00	01	01	01	01	01	01	01	01	01	01	01	01	01	01	01	01	01	01	01	01	01	04	05	01	01	01	02	02	01	01	01	01	01	01	01	01	01	01	01	02	02	01	01	01	01	01	01	01	00
00	01	01	01	01	01	01	01	01	01	01	01	01	04	05	01	01	01	01	01	01	01	01	01	02	02	01	03	03	01	01	01	01	01	01	01	01	01	01	01	03	03	01	01	01	01	01	02	02	00
00	02	02	02	02	02	02	02	02	02	02	02	01	04	05	01	01	04	05	01	01	01	01	01	03	03	01	01	01	01	01	01	01	02	02	02	02	01	01	01	01	01	02	02	01	01	01	03	03	00
00	03	03	03	03	03	03	03	03	03	03	03	01	01	01	01	01	04	05	01	01	01	01	01	01	01	01	01	01	01	01	01	01	03	03	03	03	01	01	01	01	01	03	03	01	01	01	01	01	00
00	01	01	01	01	01	01	01	01	01	01	01	01	01	01	01	01	01	01	01	01	01	01	01	01	01	01	01	02	02	01	01	01	01	01	01	01	04	05	01	01	01	01	01	01	01	01	01	01	00
00	02	02	02	02	02	02	02	02	02	02	02	01	01	01	01	01	02	02	01	01	01	01	01	01	01	01	01	03	03	01	01	02	02	01	01	01	04	05	01	01	01	01	01	01	01	01	01	01	00
00	01	01	01	01	01	01	01	01	01	01	01	01	01	01	01	01	03	03	01	01	01	01	01	01	01	01	01	01	01	01	01	03	03	01	01	01	01	01	01	01	01	01	01	01	01	01	01	01	00
00	01	01	01	01	01	01	01	01	01	01	01	01	01	01	01	01	01	01	01	01	01	01	01	01	01	01	01	01	01	01	01	01	01	01	01	01	01	01	01	01	01	01	01	01	01	01	01	01	00
00	01	01	01	01	01	01	01	01	01	01	01	01	04	05	01	02	02	01	01	01	04	05	01	01	01	01	01	01	01	04	05	01	01	01	01	01	01	01	01	01	02	02	01	01	01	01	02	02	00
00	02	02	02	02	02	02	02	02	02	02	02	01	04	05	01	03	03	01	01	01	04	05	01	01	01	01	01	01	01	04	05	01	01	01	01	01	02	02	01	01	03	03	01	01	01	01	03	03	00
00	01	01	01	01	01	01	01	01	01	01	01	01	01	01	01	01	01	01	01	01	01	01	01	01	01	01	01	01	01	01	01	01	01	01	01	01	03	03	01	01	01	01	01	01	01	01	01	01	00
00	01	01	01	01	01	01	01	01	01	01	01	01	01	01	01	01	01	01	01	01	01	01	01	01	01	02	02	01	01	01	01	01	01	04	05	01	01	01	01	01	01	01	01	02	02	01	01	01	00
00	02	02	02	02	02	02	02	02	02	02	02	01	01	01	01	01	01	01	01	01	01	01	02	02	01	03	03	01	01	02	02	01	01	04	05	01	01	01	01	01	01	01	01	03	03	01	01	01	00
00	03	03	03	03	03	03	03	03	03	03	03	01	01	01	01	01	01	01	01	01	01	01	03	03	01	01	01	01	01	03	03	01	01	01	01	01	01	01	01	01	01	01	01	01	01	01	01	01	00
00	01	01	01	01	01	01	01	01	01	01	01	01	01	01	01	02	02	01	04	05	01	01	01	01	01	01	01	01	01	01	01	01	01	01	01	01	01	01	01	04	05	01	01	01	01	01	01	01	00
00	01	01	01	01	01	01	01	01	01	01	01	01	04	05	01	03	03	01	04	05	01	01	01	01	01	01	04	05	01	01	01	01	02	02	01	01	01	01	01	04	05	01	02	02	01	01	01	01	00
00	01	01	01	01	01	01	01	01	01	01	01	01	04	05	01	01	01	01	01	01	01	01	01	01	01	01	04	05	01	01	01	01	03	03	01	01	01	01	01	01	01	01	03	03	01	01	01	01	00
00	02	02	02	02	02	02	02	02	02	02	02	01	01	01	01	01	01	01	01	01	01	01	01	01	01	01	01	01	01	01	01	01	01	01	01	01	01	01	01	02	02	01	01	01	01	01	01	08	08
00	01	01	01	01	01	01	01	01	01	01	01	01	01	01	01	01	01	01	02	02	01	01	01	01	01	01	01	04	05	01	01	01	01	01	01	01	01	01	01	03	03	01	01	01	01	01	01	08	08
00	03	03	03	03	03	03	03	03	03	03	03	01	01	01	04	05	01	01	03	03	01	01	01	01	01	01	01	04	05	01	01	01	04	05	01	01	01	01	01	01	01	01	01	01	01	01	01	08	08
00	01	01	01	01	01	01	01	01	01	01	01	01	01	01	04	05	01	01	01	01	01	02	02	01	01	01	01	01	01	01	01	01	04	05	01	02	02	01	01	01	01	01	02	02	01	01	02	02	00
00	01	04	05	01	01	01	02	02	01	01	01	01	01	01	01	01	01	01	01	01	01	03	03	01	01	01	01	01	01	01	01	01	01	01	01	03	03	01	01	01	01	01	03	03	01	01	03	03	00
00	01	04	05	01	01	01	03	03	01	01	02	02	01	01	01	01	01	01	01	01	01	01	01	01	01	01	02	02	01	01	01	01	01	01	01	01	01	01	01	02	02	01	01	01	01	01	01	01	00
00	01	01	01	01	01	01	01	01	01	01	03	03	01	01	01	04	05	01	01	01	01	01	01	01	01	01	03	03	01	01	01	01	01	01	01	01	01	01	01	03	03	01	01	01	01	01	01	01	00
00	01	01	01	02	02	01	01	01	01	01	01	01	01	01	01	04	05	01	01	01	01	01	01	01	01	01	01	01	01	01	01	02	02	01	01	01	01	01	01	01	01	01	01	01	01	01	01	01	00
00	01	01	01	03	03	01	01	01	01	01	01	01	01	01	01	01	01	01	01	01	01	01	01	01	01	01	01	01	01	01	01	03	03	01	01	01	01	01	01	04	05	01	01	02	02	01	01	01	00
00	01	01	01	01	01	01	01	01	01	01	01	01	01	02	02	01	01	01	01	01	01	02	02	01	01	02	02	01	01	01	01	01	01	01	01	04	05	01	01	04	05	01	01	03	03	01	01	01	00
00	01	01	01	01	01	01	01	01	01	01	01	01	01	03	03	01	01	01	01	01	01	03	03	01	01	03	03	01	01	01	01	01	01	01	01	04	05	01	01	01	01	01	01	01	01	01	01	01	00
00	01	02	02	01	01	01	02	02	01	01	01	01	01	01	01	01	01	01	01	01	01	01	01	01	01	01	01	01	01	02	02	01	01	01	01	01	01	01	01	01	01	01	01	01	01	01	01	01	00
00	01	03	03	01	01	01	03	03	01	01	01	01	01	02	02	01	01	01	01	01	01	01	01	01	01	01	01	01	01	03	03	01	01	02	02	01	01	01	01	02	02	01	01	01	01	01	01	01	00
00	01	01	01	01	01	01	01	01	01	01	01	01	01	03	03	01	01	01	04	05	01	01	01	01	01	01	01	01	01	01	01	01	01	03	03	01	01	01	01	03	03	01	01	01	04	05	01	01	00
00	01	01	01	01	01	01	01	01	01	01	01	01	01	01	01	01	01	01	04	05	01	01	06	01	01	06	01	01	01	01	01	01	01	01	01	01	01	01	01	01	01	01	01	01	04	05	01	01	00
00	00	00	00	00	00	00	00	00	00	00	00	00	00	00	00	00	00	00	00	00	00	00	00	00	00	00	00	00	00	00	00	00	00	00	00	00	00	00	00	00	00	00	00	00	00	00	00	00	00
