00	00	00	00	00	00	00	00	00	00	00	00	00	00	00	00	00	00	00	00	00	00	00	00	08	08	00	00	00	00	00	00	00	00	00	00	00	00	00	00	00	00	00	00	00	00	00	00	00	00
00	01	01	03	01	01	01	01	03	01	01	01	01	01	01	03	01	01	01	01	01	01	01	06	08	08	06	01	01	01	01	03	01	01	01	01	01	01	01	03	01	01	01	01	01	01	01	01	01	00
00	01	04	01	01	04	01	01	01	01	03	01	01	01	03	01	01	02	01	01	01	01	01	01	08	08	01	01	01	01	01	01	01	01	01	01	01	01	01	01	01	01	01	01	01	01	01	01	01	00
00	01	05	01	01	01	01	01	01	01	01	01	01	01	01	01	01	01	03	01	01	01	01	01	04	01	01	01	01	01	01	01	01	04	01	01	01	01	01	01	02	01	01	01	01	01	02	01	01	00
00	01	01	01	01	01	01	04	01	01	01	01	02	01	01	01	01	01	01	01	01	01	01	01	01	01	01	01	02	01	01	01	01	01	01	01	01	01	01	01	03	02	01	01	01	01	01	01	01	00
00	01	03	03	01	01	01	01	01	01	01	01	01	01	01	01	04	01	01	01	01	01	01	01	01	01	01	01	01	01	01	01	01	01	01	01	01	04	01	01	01	01	01	01	01	01	01	01	01	00
00	01	01	01	01	01	01	01	01	01	01	01	05	01	01	01	05	01	05	01	01	04	01	01	01	01	01	01	01	01	01	01	01	01	01	01	01	01	01	01	01	01	01	01	01	04	01	01	01	00
00	01	01	01	01	01	01	01	04	01	02	01	05	01	01	01	01	01	03	01	01	03	01	01	01	01	01	04	05	01	01	01	04	05	01	01	01	01	01	01	01	04	01	01	01	01	01	01	01	00
00	01	01	01	01	01	01	01	01	01	01	01	04	01	01	01	01	01	01	01	01	01	01	01	03	01	01	01	01	01	01	01	01	01	01	01	01	01	01	01	01	01	01	05	01	01	01	01	01	00
00	01	01	01	01	01	04	01	01	01	01	01	01	01	01	01	04	02	01	01	01	01	01	01	01	01	01	01	01	01	01	01	01	01	01	01	01	04	01	01	01	01	01	01	01	01	01	01	01	00
00	01	04	01	01	01	01	01	01	01	01	02	01	01	02	01	01	01	01	01	01	01	01	01	01	01	01	01	01	01	02	01	01	01	01	01	01	01	01	01	01	01	01	01	01	01	04	01	01	00
00	01	01	01	01	01	01	03	01	01	01	01	01	01	01	01	01	01	01	03	01	01	05	01	04	01	01	01	05	01	01	01	01	01	05	01	04	01	01	01	01	01	05	01	01	01	01	01	04	00
00	01	01	01	01	01	01	01	01	01	01	01	01	01	01	01	01	01	01	01	01	01	01	01	01	01	01	01	01	01	01	01	01	01	01	01	01	01	01	02	01	01	01	01	01	01	01	01	01	00
00	05	01	01	01	01	01	01	01	01	01	01	03	01	01	01	01	05	01	01	01	01	01	01	01	01	01	01	01	01	01	04	01	05	01	01	01	01	01	01	01	01	01	01	01	01	01	01	01	00
00	01	01	01	01	04	03	01	01	01	01	01	01	01	01	02	05	01	01	01	01	01	04	01	01	05	01	01	01	01	01	01	01	01	01	01	01	01	01	01	01	05	01	04	01	01	01	01	01	00
00	01	01	01	01	01	01	01	01	04	01	01	01	01	01	01	01	01	01	01	04	01	01	01	01	01	01	01	01	01	01	02	01	01	01	01	02	01	01	01	01	01	01	01	01	01	01	01	04	00
00	01	03	01	01	01	01	01	01	01	01	01	01	03	01	01	02	01	01	01	01	01	01	01	01	01	01	01	01	01	01	01	01	01	01	01	01	01	01	01	01	01	01	01	01	01	01	01	01	00
00	01	01	01	01	01	01	01	01	01	01	04	01	01	01	01	01	01	01	01	01	01	01	01	01	01	01	04	01	01	05	01	01	05	01	01	01	01	04	01	01	01	01	01	01	01	01	01	01	00
00	01	01	01	01	01	01	01	01	01	01	01	01	01	01	02	01	01	05	01	01	01	04	01	01	01	01	01	01	01	01	01	01	01	01	01	01	01	01	01	01	01	01	01	01	01	01	01	01	00
00	01	01	04	01	03	01	01	04	01	02	01	01	01	01	01	01	01	01	01	01	02	01	01	01	01	01	01	01	01	01	01	01	01	01	04	01	01	01	01	01	01	01	05	01	01	01	01	01	00
00	01	01	01	01	01	01	01	01	01	01	01	01	01	05	01	05	01	01	01	01	01	01	01	01	01	02	01	01	01	01	02	01	01	01	01	01	01	01	01	01	01	01	01	01	04	01	01	01	00
00	01	01	02	01	01	01	01	01	01	05	01	01	01	04	01	01	01	02	01	01	01	01	03	01	01	01	01	04	01	01	01	01	01	01	01	01	01	01	01	01	04	01	01	02	01	01	01	01	00
00	05	01	01	01	03	01	01	01	01	01	01	01	01	05	01	01	01	01	03	01	01	01	01	01	01	01	01	01	01	01	01	01	01	01	01	01	01	05	01	01	01	01	01	01	01	01	01	01	00
00	01	01	01	01	01	01	01	04	01	01	01	01	01	01	01	01	01	01	01	01	01	01	01	01	01	01	01	02	01	01	01	03	01	01	04	01	01	01	01	01	01	01	01	01	01	01	01	04	00
00	01	01	01	01	01	01	01	01	01	01	01	02	01	01	01	01	01	01	01	01	01	01	01	01	01	01	01	03	01	01	01	01	01	01	01	01	01	01	01	01	01	01	02	01	01	04	01	01	00
00	01	01	01	01	01	01	01	01	01	01	01	01	01	01	01	04	01	01	01	02	01	01	01	01	01	01	01	01	01	01	01	01	01	01	01	01	04	01	01	01	05	01	01	01	01	01	01	01	00
00	05	01	01	01	04	01	03	01	01	04	01	01	01	01	01	01	01	01	01	01	01	01	01	01	01	01	01	01	01	03	01	01	01	01	01	01	01	01	01	01	01	01	01	01	01	01	01	01	00
00	01	01	01	01	01	01	01	01	01	01	01	01	01	01	04	01	01	01	01	01	01	01	01	01	01	04	01	01	01	01	02	02	01	01	01	01	01	03	01	01	01	01	01	02	01	03	01	01	00
00	01	03	01	01	01	01	01	03	01	01	02	01	01	01	01	01	01	01	01	04	01	01	05	01	01	01	01	05	01	01	01	01	04	01	01	01	01	01	01	01	01	04	01	01	01	01	01	01	00
00	01	01	01	01	01	01	01	01	01	01	01	01	01	01	01	01	01	01	01	01	01	01	01	01	01	01	01	04	05	01	01	01	01	01	01	04	01	01	01	01	01	01	01	01	01	01	01	01	00
00	01	01	01	01	01	01	01	01	01	01	01	01	01	01	05	01	01	01	01	01	01	01	01	01	01	01	01	01	01	01	01	01	01	01	01	01	01	05	01	01	01	01	01	01	04	01	01	01	00
00	01	01	01	04	01	01	01	01	01	01	05	01	01	01	01	01	01	01	01	01	01	04	05	01	01	01	01	01	03	01	01	04	01	01	01	01	01	01	01	01	01	01	01	01	01	01	01	04	00
00	05	01	01	01	01	01	01	04	01	01	01	01	01	01	04	01	01	05	01	01	01	01	01	01	01	01	02	01	01	01	01	01	01	01	01	01	01	01	03	01	01	01	01	01	01	01	01	01	00
00	01	01	01	01	01	01	01	01	01	01	01	01	01	01	05	01	01	01	01	01	01	01	01	01	01	01	01	01	01	03	03	01	01	01	01	01	01	01	01	01	01	02	01	01	01	01	01	01	00
00	01	01	01	01	02	01	01	01	01	01	01	01	01	01	01	01	01	01	01	01	05	01	01	01	01	01	01	01	01	01	01	01	01	01	01	01	02	01	01	04	01	01	01	04	01	01	01	01	00
00	03	03	01	01	01	01	01	01	01	01	03	01	01	01	01	03	03	01	03	05	01	01	01	01	04	01	01	01	01	01	01	01	01	01	01	01	01	01	01	01	01	01	01	01	01	01	01	04	00
00	01	01	01	01	01	01	04	01	01	01	01	01	01	01	01	01	01	01	01	01	01	01	01	01	01	01	01	04	01	01	01	01	01	04	01	01	01	01	01	01	01	01	01	02	01	01	01	01	00
00	01	01	01	01	01	01	01	01	01	01	01	01	01	01	01	02	02	01	01	01	01	03	01	01	01	01	01	01	03	01	01	01	01	01	01	01	01	01	01	01	01	01	01	01	01	01	01	01	00
00	01	01	01	01	01	01	01	01	01	01	01	04	01	01	01	01	01	01	02	01	01	01	01	01	01	01	01	01	01	01	01	01	01	01	01	01	03	01	01	01	01	01	01	01	01	01	01	01	00
00	01	04	01	03	01	01	01	01	01	02	01	01	01	01	01	01	01	01	01	01	01	04	01	01	01	01	01	01	01	01	01	02	05	01	01	01	01	01	01	04	01	01	01	01	04	01	01	01	00
00	01	01	01	01	01	01	03	01	01	01	01	01	03	01	01	01	01	01	01	01	01	01	01	01	01	01	01	05	01	01	01	01	01	01	01	01	01	01	01	01	01	01	01	01	01	01	01	04	00
00	01	01	01	01	01	01	01	01	01	05	01	01	01	01	01	04	01	01	05	01	01	01	01	01	04	01	01	01	01	01	01	01	01	01	01	01	01	05	01	01	01	02	01	01	01	01	01	01	00
00	05	01	01	01	01	02	01	01	01	01	01	01	01	01	01	01	01	01	01	01	01	01	01	01	01	01	01	01	01	01	04	05	01	01	01	04	01	01	01	01	01	01	01	01	01	01	01	01	00
00	01	02	01	01	01	01	01	01	03	01	01	01	01	01	01	01	01	01	01	01	01	01	01	01	01	01	01	01	01	01	01	01	01	01	01	01	01	01	01	05	01	01	01	01	01	03	01	01	00
00	01	01	01	01	01	01	01	01	01	01	02	01	01	01	01	05	01	01	01	01	04	01	01	01	01	01	01	03	01	01	01	01	01	02	01	01	01	01	01	01	01	01	01	01	01	01	01	01	00
00	01	01	03	01	05	01	01	04	01	01	01	01	03	01	04	01	01	01	01	01	01	01	01	01	01	01	01	01	01	01	04	01	01	01	01	01	03	01	01	01	01	01	04	01	01	01	05	01	00
00	05	01	01	01	02	01	01	01	01	01	01	01	01	01	01	01	01	01	05	01	01	01	01	05	01	01	01	01	01	01	01	01	01	01	01	01	01	01	01	05	01	01	01	01	05	01	01	01	00
00	01	01	01	01	01	01	01	01	01	01	01	01	01	01	01	01	01	01	01	01	01	01	01	01	01	01	01	01	01	01	01	01	01	01	01	01	01	04	01	01	01	01	01	01	01	01	01	01	00
00	01	01	01	02	01	01	01	01	01	02	01	01	01	01	01	01	02	01	01	01	01	01	06	01	01	06	01	01	02	01	01	01	01	01	01	01	01	01	01	01	01	01	02	01	01	01	01	01	00
00	00	00	00	00	00	00	00	00	00	00	00	00	00	00	00	00	00	00	00	00	00	00	00	00	00	00	00	00	00	00	00	00	00	00	00	00	00	00	00	00	00	00	00	00	00	00	00	00	00
