00	00	00	00	00	00	00	00	00	00	00	00	00	00	00	00	00	00	00	00	00	00	00	00	00	00	00	00	00	00	00	00	00	00	00	00	00	00	00	00	00	00	00	00	00	00	00	00	00	00
00	00	03	03	03	03	03	03	03	03	03	03	03	03	03	03	03	03	03	03	03	03	03	06	01	01	06	03	03	03	03	03	03	03	03	03	03	03	03	03	03	03	03	03	03	03	03	03	00	00
00	05	01	01	01	01	01	01	01	01	01	01	01	01	01	01	01	01	01	01	01	01	01	01	01	01	01	01	01	01	01	01	01	01	01	01	01	01	01	01	01	01	01	01	01	01	08	08	04	00
00	05	01	01	01	01	01	01	01	01	01	01	01	01	01	01	01	01	01	01	01	01	01	01	01	01	01	01	01	01	01	01	01	01	01	01	01	01	01	01	01	01	01	01	01	01	08	08	04	00
00	05	01	01	01	02	02	02	02	02	02	02	02	02	02	02	02	02	02	02	02	02	02	02	01	01	02	02	02	02	02	02	02	02	02	02	02	02	02	02	02	02	02	02	02	01	01	01	04	00
00	05	01	01	04	00	03	03	03	03	03	03	03	03	03	03	03	03	03	03	03	03	03	03	01	01	03	03	03	03	03	03	03	03	03	03	03	03	03	03	03	03	03	03	00	05	01	01	04	00
00	05	01	01	04	05	01	01	01	01	01	01	01	01	01	01	01	01	01	01	01	01	01	01	01	01	01	01	01	01	01	01	01	01	01	01	01	01	01	01	01	01	01	01	04	05	01	01	04	00
00	05	01	01	04	05	01	01	01	01	01	01	01	01	01	01	01	01	01	01	01	01	01	01	01	01	01	01	01	01	01	01	01	01	01	01	01	01	01	01	01	01	01	01	04	05	01	01	04	00
00	05	01	01	04	05	01	01	01	02	02	02	02	02	02	02	02	02	02	02	02	02	02	02	01	01	02	02	02	02	02	02	02	02	02	02	02	02	02	02	02	01	01	01	04	05	01	01	04	00
00	05	01	01	04	05	01	01	04	00	03	03	03	03	03	03	03	03	03	03	03	03	03	03	01	01	03	03	03	03	03	03	03	03	03	03	03	03	03	03	00	05	01	01	04	05	01	01	04	00
00	05	01	01	04	05	01	01	04	05	01	01	01	01	01	01	01	01	01	01	01	01	01	01	01	01	01	01	01	01	01	01	01	01	01	01	01	01	01	01	04	05	01	01	04	05	01	01	04	00
00	05	01	01	04	05	01	01	04	05	01	01	01	01	01	01	01	01	01	01	01	01	01	01	01	01	01	01	01	01	01	01	01	01	01	01	01	01	01	01	04	05	01	01	04	05	01	01	04	00
00	05	01	01	04	05	01	01	04	05	01	01	01	02	02	02	02	02	02	02	02	02	02	02	01	01	02	02	02	02	02	02	02	02	02	02	02	01	01	01	04	05	01	01	04	05	01	01	04	00
00	05	01	01	04	05	01	01	04	05	01	01	04	00	03	03	03	03	03	03	03	03	03	03	01	01	03	03	03	03	03	03	03	03	03	03	00	05	01	01	04	05	01	01	04	05	01	01	04	00
00	05	01	01	04	05	01	01	04	05	01	01	04	05	01	01	01	01	01	01	01	01	01	01	01	01	01	01	01	01	01	01	01	01	01	01	04	05	01	01	04	05	01	01	04	05	01	01	04	00
00	05	01	01	04	05	01	01	04	05	01	01	04	05	01	01	01	01	01	01	01	01	01	01	01	01	01	01	01	01	01	01	01	01	01	01	04	05	01	01	04	05	01	01	04	05	01	01	04	00
00	05	01	01	04	05	01	01	04	05	01	01	04	05	01	01	01	02	02	02	02	02	02	02	01	01	02	02	02	02	02	02	02	01	01	01	04	05	01	01	04	05	01	01	04	05	01	01	04	00
00	05	01	01	04	05	01	01	04	05	01	01	04	05	01	01	04	00	03	03	03	03	03	03	01	01	03	03	03	03	03	03	00	05	01	01	04	05	01	01	04	05	01	01	04	05	01	01	04	00
00	05	01	01	04	05	01	01	04	05	01	01	04	05	01	01	04	05	01	01	01	01	01	01	01	01	01	01	01	01	01	01	04	05	01	01	04	05	01	01	04	05	01	01	04	05	01	01	04	00
00	05	01	01	04	05	01	01	04	05	01	01	04	05	01	01	04	05	01	01	01	01	01	01	01	01	01	01	01	01	01	01	04	05	01	01	04	05	01	01	04	05	01	01	04	05	01	01	04	00
00	05	01	01	04	05	01	01	04	05	01	01	04	05	01	01	04	05	01	01	01	02	02	02	01	01	02	02	02	01	01	01	04	05	01	01	04	05	01	01	04	05	01	01	04	05	01	01	04	00
00	05	01	01	04	05	01	01	04	05	01	01	04	05	01	01	04	05	01	01	04	00	03	03	01	01	03	03	00	05	01	01	04	05	01	01	04	05	01	01	04	05	01	01	04	05	01	01	04	00
00	05	01	01	04	05	01	01	04	05	01	01	04	05	01	01	04	05	01	01	04	05	01	01	01	01	01	01	04	05	01	01	04	05	01	01	04	05	01	01	04	05	01	01	04	05	01	01	04	00
00	05	01	01	01	01	01	01	01	01	01	01	01	01	01	01	01	01	01	01	01	01	01	01	07	07	01	01	01	01	01	01	01	01	01	01	01	01	01	01	01	01	01	01	01	01	01	01	04	00
00	05	01	01	01	01	01	01	01	01	01	01	01	01	01	01	01	01	01	01	01	01	01	01	07	07	01	01	01	01	01	01	01	01	01	01	01	01	01	01	01	01	01	01	01	01	01	01	04	00
00	05	01	01	04	05	01	01	04	05	01	01	04	05	01	01	04	05	01	01	04	05	01	01	01	01	01	01	04	05	01	01	04	05	01	01	04	05	01	01	04	05	01	01	04	05	01	01	04	00
00	05	01	01	04	05	01	01	04	05	01	01	04	05	01	01	04	05	01	01	04	05	01	01	01	01	01	01	04	05	01	01	04	05	01	01	04	05	01	01	04	05	01	01	04	05	01	01	04	00
00	05	01	01	04	05	01	01	04	05	01	01	04	05	01	01	04	05	01	01	04	05	01	01	01	01	01	01	04	05	01	01	04	05	01	01	04	05	01	01	04	05	01	01	04	05	01	01	04	00
00	05	01	01	04	05	01	01	04	05	01	01	04	05	01	01	04	05	01	01	04	00	02	02	01	01	02	02	00	05	01	01	04	05	01	01	04	05	01	01	04	05	01	01	04	05	01	01	04	00
00	05	01	01	04	05	01	01	04	05	01	01	04	05	01	01	04	05	01	01	01	03	03	03	01	01	03	03	03	01	01	01	04	05	01	01	04	05	01	01	04	05	01	01	04	05	01	01	04	00
00	05	01	01	04	05	01	01	04	05	01	01	04	05	01	01	04	05	01	01	01	01	01	01	01	01	01	01	01	01	01	01	04	05	01	01	04	05	01	01	04	05	01	01	04	05	01	01	04	00
00	05	01	01	04	05	01	01	04	05	01	01	04	05	01	01	04	05	01	01	01	01	01	01	01	01	01	01	01	01	01	01	04	05	01	01	04	05	01	01	04	05	01	01	04	05	01	01	04	00
00	05	01	01	04	05	01	01	04	05	01	01	04	05	01	01	04	00	02	02	02	02	02	02	01	01	02	02	02	02	02	02	00	05	01	01	04	05	01	01	04	05	01	01	04	05	01	01	04	00
00	05	01	01	04	05	01	01	04	05	01	01	04	05	01	01	01	03	03	03	03	03	03	03	01	01	03	03	03	03	03	03	03	01	01	01	04	05	01	01	04	05	01	01	04	05	01	01	04	00
00	05	01	01	04	05	01	01	04	05	01	01	04	05	01	01	01	01	01	01	01	01	01	01	01	01	01	01	01	01	01	01	01	01	01	01	04	05	01	01	04	05	01	01	04	05	01	01	04	00
00	05	01	01	04	05	01	01	04	05	01	01	04	05	01	01	01	01	01	01	01	01	01	01	01	01	01	01	01	01	01	01	01	01	01	01	04	05	01	01	04	05	01	01	04	05	01	01	04	00
00	05	01	01	04	05	01	01	04	05	01	01	04	00	02	02	02	02	02	02	02	02	02	02	01	01	02	02	02	02	02	02	02	02	02	02	00	05	01	01	04	05	01	01	04	05	01	01	04	00
00	05	01	01	04	05	01	01	04	05	01	01	01	03	03	03	03	03	03	03	03	03	03	03	01	01	03	03	03	03	03	03	03	03	03	03	03	01	01	01	04	05	01	01	04	05	01	01	04	00
00	05	01	01	04	05	01	01	04	05	01	01	01	01	01	01	01	01	01	01	01	01	01	01	01	01	01	01	01	01	01	01	01	01	01	01	01	01	01	01	04	05	01	01	04	05	01	01	04	00
00	05	01	01	04	05	01	01	04	05	01	01	01	01	01	01	01	01	01	01	01	01	01	01	01	01	01	01	01	01	01	01	01	01	01	01	01	01	01	01	04	05	01	01	04	05	01	01	04	00
00	05	01	01	04	05	01	01	04	00	02	02	02	02	02	02	02	02	02	02	02	02	02	02	01	01	02	02	02	02	02	02	02	02	02	02	02	02	02	02	00	05	01	01	04	05	01	01	04	00
00	05	01	01	04	05	01	01	01	03	03	03	03	03	03	03	03	03	03	03	03	03	03	03	01	01	03	03	03	03	03	03	03	03	03	03	03	03	03	03	03	01	01	01	04	05	01	01	04	00
00	05	01	01	04	05	01	01	01	01	01	01	01	01	01	01	01	01	01	01	01	01	01	01	01	01	01	01	01	01	01	01	01	01	01	01	01	01	01	01	01	01	01	01	04	05	01	01	04	00
00	05	01	01	04	05	01	01	01	01	01	01	01	01	01	01	01	01	01	01	01	01	01	01	01	01	01	01	01	01	01	01	01	01	01	01	01	01	01	01	01	01	01	01	04	05	01	01	04	00
00	05	01	01	04	00	02	02	02	02	02	02	02	02	02	02	02	02	02	02	02	02	02	02	01	01	02	02	02	02	02	02	02	02	02	02	02	02	02	02	02	02	02	02	00	05	01	01	04	00
00	05	01	01	01	03	03	03	03	03	03	03	03	03	03	03	03	03	03	03	03	03	03	03	01	01	03	03	03	03	03	03	03	03	03	03	03	03	03	03	03	03	03	03	03	01	01	01	04	00
00	05	01	01	01	01	01	01	01	01	01	01	01	01	01	01	01	01	01	01	01	01	01	01	01	01	01	01	01	01	01	01	01	01	01	01	01	01	01	01	01	01	01	01	01	01	01	01	04	00
00	05	01	01	01	01	01	01	01	01	01	01	01	01	01	01	01	01	01	01	01	01	01	01	01	01	01	01	01	01	01	01	01	01	01	01	01	01	01	01	01	01	01	01	01	01	01	01	04	00
00	00	02	02	02	02	02	02	02	02	02	02	02	02	02	02	02	02	02	02	02	02	02	06	01	01	06	02	02	02	02	02	02	02	02	02	02	02	02	02	02	02	02	02	02	02	02	02	00	00
00	00	00	00	00	00	00	00	00	00	00	00	00	00	00	00	00	00	00	00	00	00	00	00	00	00	00	00	00	00	00	00	00	00	00	00	00	00	00	00	00	00	00	00	00	00	00	00	00	00
