00	00	00	00	00	00	00	00	00	00	00	00	00	00	00	00	00	00	00	00	00	00	00	00	00
00	03	03	03	03	03	03	03	03	03	03	03	03	03	03	03	03	03	03	03	03	03	03	03	00
05	06	01	01	01	01	01	01	01	01	01	01	01	01	01	01	01	01	01	01	01	01	01	06	04
05	01	01	01	01	01	01	01	01	01	01	01	01	01	01	01	01	01	01	01	01	01	01	01	04
05	01	01	02	02	02	02	02	02	02	02	01	01	01	02	02	02	02	02	02	02	02	01	01	04
05	01	01	03	03	03	03	03	03	03	03	01	01	01	03	03	03	03	03	03	03	03	01	01	04
05	01	01	01	01	01	01	01	01	01	01	01	01	01	01	01	01	01	01	01	01	01	01	01	04
05	01	01	01	01	01	01	01	01	01	01	01	01	01	01	01	01	01	01	01	01	01	01	01	04
05	01	01	02	02	02	02	02	02	02	02	01	01	01	02	02	02	02	02	02	02	02	01	01	04
05	01	01	03	03	03	03	03	03	03	03	01	01	01	03	03	03	03	03	03	03	03	01	01	04
05	01	01	01	01	01	01	01	01	01	01	01	01	01	01	01	01	01	01	01	01	01	01	01	04
05	01	01	01	01	01	01	01	01	01	01	01	01	01	01	01	01	01	01	01	01	01	01	01	04
05	01	01	02	02	02	02	02	02	02	02	01	01	01	02	02	02	02	02	02	02	02	01	01	04
05	01	01	03	03	03	03	03	03	03	03	01	01	01	03	03	03	03	03	03	03	03	01	01	04
05	01	01	01	01	01	01	01	01	01	01	01	01	01	01	01	01	01	01	01	01	01	01	01	04
05	01	01	01	01	01	01	01	01	01	01	01	01	01	01	01	01	01	01	01	01	01	01	01	04
05	01	01	02	02	02	02	02	02	02	02	01	01	01	02	02	02	02	02	02	02	02	01	01	04
05	01	01	03	03	03	03	03	03	03	03	01	01	01	03	03	03	03	03	03	03	03	01	01	04
05	01	01	01	01	01	01	01	01	01	01	01	01	01	01	01	01	01	01	01	01	01	01	01	04
05	01	01	01	01	01	01	01	01	01	01	01	01	01	01	01	01	01	01	01	01	01	01	01	04
05	01	01	02	02	02	02	02	02	02	02	01	01	01	02	02	02	02	02	02	02	02	01	01	04
05	01	01	03	03	03	03	03	03	03	03	01	01	01	03	03	03	03	03	03	03	03	01	01	04
05	01	01	01	01	01	01	01	01	01	01	08	08	08	01	01	01	01	01	01	01	01	01	01	04
05	06	01	01	01	01	01	01	01	01	01	08	08	08	01	01	01	01	01	01	01	01	01	06	04
00	02	02	02	02	02	02	02	02	02	00	08	08	08	00	02	02	02	02	02	02	02	02	02	00
