00	00	00	00	00	00	00	00	00	00	00	00	00	00	00	00	00	00	00	00	00	00	00	00	00
00	06	01	01	01	01	01	01	01	01	01	01	01	01	01	01	01	01	01	01	01	01	01	06	00
00	01	04	05	01	02	02	02	02	02	02	02	02	02	02	02	02	02	02	02	01	04	05	01	00
00	01	04	05	01	03	03	03	03	03	03	03	03	03	03	03	03	03	03	03	01	04	05	01	00
00	01	04	05	01	01	01	01	01	01	01	01	01	01	01	01	01	01	01	01	01	04	05	01	00
00	01	04	05	01	04	05	01	02	02	02	02	02	02	02	02	02	01	04	05	01	04	05	01	00
00	01	04	05	01	04	05	01	03	03	03	03	03	03	03	03	03	01	04	05	01	04	05	01	00
00	01	04	05	01	04	05	01	01	01	01	01	01	01	01	01	01	01	04	05	01	04	05	01	00
00	01	04	05	01	04	05	01	04	05	01	02	02	02	01	04	05	01	04	05	01	04	05	01	00
00	01	04	05	01	04	05	01	04	05	01	03	03	03	01	04	05	01	04	05	01	04	05	01	00
00	01	04	05	01	04	05	01	04	05	01	01	01	01	01	04	05	01	04	05	01	04	05	01	00
00	01	04	05	01	04	05	01	04	05	01	02	02	02	01	04	05	01	04	05	01	04	05	01	00
00	01	04	05	01	04	05	01	04	05	01	03	03	03	01	04	05	01	04	05	01	04	05	01	00
00	01	04	05	01	04	05	01	04	05	01	01	01	01	01	04	05	01	04	05	01	04	05	01	00
00	01	04	05	01	04	05	01	04	05	01	02	02	02	01	04	05	01	04	05	01	04	05	01	00
00	01	04	05	01	04	05	01	04	05	01	03	03	03	01	04	05	01	04	05	01	04	05	01	00
00	01	04	05	01	04	05	01	04	05	01	01	01	01	01	04	05	01	04	05	01	04	05	01	00
00	01	04	05	01	04	05	01	04	05	01	02	02	02	01	04	05	01	04	05	01	04	05	01	00
00	01	04	05	01	04	05	01	04	05	01	03	03	03	01	04	05	01	04	05	01	04	05	01	00
00	01	04	05	01	04	05	01	04	05	01	01	01	01	01	04	05	01	04	05	01	04	05	01	00
00	01	04	05	01	04	05	01	04	05	01	02	02	02	01	04	05	01	04	05	01	04	05	01	00
00	01	04	05	01	04	05	01	04	05	01	03	03	03	01	04	05	01	04	05	01	04	05	01	00
00	01	04	05	01	04	05	01	04	05	01	01	01	01	01	04	05	01	04	05	01	04	05	01	00
00	06	01	01	01	01	01	01	01	01	01	08	08	08	01	01	01	01	01	01	01	01	01	06	00
00	00	00	00	00	00	00	00	00	00	00	08	08	08	00	00	00	00	00	00	00	00	00	00	00
